30 15
##############################
#S......$.........$.........#
#..............................
#.....$....#####......$....F#
#.......#########..........#
#...$.................$.....#
#.....####......####........#
#...............#######.....#
#...$......................$#
#.....####.......####.......#
#.............#######.......#
#..$........E...........E...#
#......####......####......##
#s..$....................$..#
##############################